         *
 *    ** *
         *
     * * *
  *    *  
     *   *
     * * *
*      * *
          
      *** 
Random strategy